1111111111
1000000000001
11PCE00000001
1111111111
