1111111111
10P0001001
1000001001
1010011001
1000000E01
1111111111
