1111111111
1P0000C001
1111111111
100000E001
1111111111
