1111111111
1000001001
1000001001
10C0011001
1C00000E01
1111111111
