1111111111
10P0001001
1000001001
10C0011001
1000000E01
1111011111
